111111111111111111
1E0000000000000001
100000000001000001
100000001110000001
100000000001000001
1010T1010000010101
1010010010C0010101
101001000000010101
101000001000010101
1P00000000000000C1
101000001000010101
10000C000000010001
101000001000010101
100000000001000001
100000001110000001
111111111111111111
