P11111111111111111
1E0000000000000001
101001010000010101
1010010010C0010101
1000000000000000C1
111111111111111111
