E1111111111111111P
1E0000000000000P01
101001010000010101
1010010010C0010101
1000000T00000000C1
111111111111111111
